barcode	enhancer	USR
AAAGCACAAAGCCGC	empty	FALSE
AGAAACCAGAACCAT	empty	FALSE
AGTACGGACGTGGTC	empty	FALSE
CAAACAACGACAACG	empty	FALSE
GTCCAGGGCCATAGT	35S	FALSE
CTTCGTCCGAGCGAA	35S	FALSE
CTCCGAGGACTCGGG	35S	FALSE
AAAGCTATGGCTCCT	35S	FALSE
CCTCCAGTTCGAGAT	35S	FALSE
CCGAAAGATATCGTC	35S	FALSE
CACAGAGCGACCGTT	35S	TRUE
GGAGCCCCGGCCATG	35S	TRUE
AAAGCACAAAGTATG	35S	TRUE
ACGCTTAAGCCTCAT	35S	TRUE
CCTCACCACAATCTG	35S	TRUE
AATATAAATGCACCA	35S	TRUE
GACATTCTCAGAATC	35S	TRUE
ATAGGCACTAAACCA	35S	TRUE
ACAGAAACAGTGCGA	35S	TRUE
CAAACTACAGCGAAG	empty	TRUE
ACGCAAACCGGCATG	empty	TRUE
CTGCCGAGGGCAGAG	empty	TRUE
AACATCCGGCCAGTG	empty	TRUE
CCGATTCAAGCGCGT	empty	TRUE
AACCACGCCCCAAAG	empty	TRUE
ATCCATACCCATACA	empty	TRUE
GAGCAAGATATTCCA	empty	TRUE
CACCGCCATAAGACC	empty	TRUE