barcode	enhancer	location
AAAGCACAAAGCCGC	none	down
AGAAACCAGAACCAT	none	down
AGTACGGACGTGGTC	none	down
CAAACAACGACAACG	none	down
GTCCAGGGCCATAGT	fwd	down
CTTCGTCCGAGCGAA	fwd	down
CTCCGAGGACTCGGG	fwd	down
AAAGCTATGGCTCCT	fwd	down
CCTCCAGTTCGAGAT	fwd	down
CCGAAAGATATCGTC	fwd	down
AATATACCAAGCAGC	rev	down
ACAACTCCTATCACT	rev	down
AGCACCGAAGATCCA	rev	down
AGCCCCCACAGCGCT	rev	down
CAACATAAAGTACGC	rev	down
CTCGGTATTCCAGAC	rev	down
GACATGGTACAAAGT	rev	down
AGAATTCTAGCGGGC	rev	down
GCACACACTAGGGGT	rev	down
GCCCTGAAACTCAGC	rev	down
AACCCAAAGGTCCTG	2xfwd	down
ACCAACCTGCAAGGC	2xfwd	down
ACCCCGACGACAGAT	2xfwd	down
AGGCCGGTTAGACCG	2xfwd	down
ATCAGTGATCTTATG	2xfwd	down
ATGACGATCGCGGTC	2xfwd	down
CAGCGGAGACAAGCT	2xfwd	down
CATCCTGTTATCGAA	2xfwd	down
CCCATTGGGCATATC	2xfwd	down
GAACTAGCTGAACCA	2xfwd	down
AATAGTCTCCGCAGC	2xrev	down
AGTCGGAAAATGAGT	2xrev	down
ATCCATGCGACCGGT	2xrev	down
CCTACTCTTGGTAAA	2xrev	down
CTTCTACGGGCAATG	2xrev	down
GATGAACGAGCCAAA	2xrev	down
GCACTTAAACTCGAC	2xrev	down
GCTATAGCAGATATT	2xrev	down
GTAACTGGTGAAACA	2xrev	down
GGACTAAAGAAACGC	2xrev	down
CCCATCGCTGCCCTA	none	up
AGCACGACCAAGGAG	none	up
CCCGTCCTTCGCAGA	none	up
GTAATAAGGGTCAAT	none	up
CCGATAGTAACCAGC	none	up
AACACGATAGGCACT	none	up
AACGCAATAGACGAG	none	up
CGCACTACCGGAGAC	none	up
GAACAGATTAACAGC	none	up
TACACGATAGGCACT	none	up
GTCAACGACATGGGC	fwd	up
ACTCACAGCAATACC	fwd	up
ATAATAGGTGAAGCA	fwd	up
ACCCTACAGAGGGTC	fwd	up
AGAGTTATCCGTCAG	fwd	up
AGAAGTCCCAACCTG	fwd	up
CGAGTAGAACAACAC	fwd	up
GCCGAAGTTCTACAG	fwd	up
CATCATGCAGTAATA	fwd	up
AGAAAAAAAGTACCG	rev	up
CCACGACAAACAGTG	rev	up
ATCGGACGGATAATT	rev	up
GAAGATCAGAAACAA	rev	up
AGGCAAGAGATCATT	rev	up
AAAAATATCGAGCGG	rev	up
CACCTAGGTGGGAAA	rev	up
ACTACGGTGAAAATT	rev	up
AAGGGAGTCCCGGAT	rev	up
GACCCCAGCGTGACT	2xfwd	up
CATAGGGAAATTACC	2xfwd	up
ACAGACACGATCCAC	2xfwd	up
CTTCCTGATCGGCCT	2xfwd	up
CACCCGACTGATGAA	2xfwd	up
CACCACGGACTAGCC	2xfwd	up
GCTGTCAGAATTCAT	2xfwd	up
CATGATGCGGATGCA	2xfwd	up
CATATAAAAGCGACC	2xfwd	up
CGGCAGCTAACGCCA	2xfwd	up
CCTAAACATCGGGTG	2xrev	up
GCGCCTAAGAACGAG	2xrev	up
ATTATGGCTGTCCGT	2xrev	up
CTCAATATTCAGCTG	2xrev	up
CTTAATGCCAATGTC	2xrev	up
GTCAATGTAAAGGAT	2xrev	up
GAACAAGCTGGGAAT	2xrev	up
AATCAGAATAGACGA	2xrev	up
GCAATACAGGTCGAC	2xrev	up
CAACGGCGCCTAAGA	2xrev	up
AAACGCACACGGGGG	none	up2
CGACAGAGAATGGCG	none	up2
CAGAATAATATACTA	none	up2
GCTGACCCGACCAGC	none	up2
CACAGAAAGCGTGCG	none	up2
ACAATAGAACCAGAG	none	up2
CGACCTATACGGACA	none	up2
ACTACGGTTACTGGA	none	up2
GGGCTCAAACTTATC	none	up2
CACAGCAATGAAGCT	fwd	up2
GGGGCCCCGAATCTA	fwd	up2
CAAATACTTCACAGC	fwd	up2
CACAAGGACGTTCCG	fwd	up2
AGGGCCAGCCGAAGT	fwd	up2
GGCGTACGAAAGACA	fwd	up2
GATACCGTACCAGTA	fwd	up2
AAGAGTCGCGGGGCT	fwd	up2
GGGGCCAGCCGAAGT	fwd	up2
AACATTAACAGCGTG	fwd	up2
ACTCTTGAACATGCA	rev	up2
CGTGCACAAAAGGTG	rev	up2
GGCATCGAAATCCTT	rev	up2
GGTCTGAAGCTTGAT	rev	up2
ATAAATAGCCGCCGG	rev	up2
GTGCTGCAACCGGGC	rev	up2
GTGCTCGGCATGAAA	rev	up2
GCTAGGCTACTTCGA	rev	up2
GCTCTTGAACATGCA	rev	up2
CGGCCTAGGATTATA	rev	up2
GTAATTCAACGTGCA	2xfwd	up2
ACACCTGCCAGACAG	2xfwd	up2
ATAACTGTCCTTGGA	2xfwd	up2
CTTAGACAACTTAGA	2xfwd	up2
CCCAAACGGAATAAA	2xfwd	up2
GCTACACCAATAGAT	2xfwd	up2
AATCCGCGTAGAATT	2xfwd	up2
GCGCGTGTACGACCT	2xfwd	up2
GCACCTGCCAGACAG	2xfwd	up2
CAGCCAGTAAAAGTT	2xrev	up2
CGACCGAGACATCCA	2xrev	up2
ACTGTCCGGATACAT	2xrev	up2
CTGAAACGTAATACT	2xrev	up2
GGTAAGGAACTTGCG	2xrev	up2
GAAACGAGAGTTATA	2xrev	up2
AGCACACGTAGAAAC	2xrev	up2
GAGCGAGAACATCGT	2xrev	up2
ATGAACCATGGCCTA	none	down2
ACACACACAATCCAG	none	down2
AGTACGACCGCGAAC	none	down2
GACGGGCAACCACTA	none	down2
CATCACATTAAAACT	none	down2
ATGAACCATCGCCTA	none	down2
AACGGTGTACGTCCC	none	down2
GAACAGCCAGACGTG	none	down2
ACGCAAGCAACACGT	none	down2
GTCGACGTCCTAAAG	none	down2
CTCAATCGGACACTA	fwd	down2
ATTAGTGATACTCCA	fwd	down2
AGGAGGATGCTCAAA	fwd	down2
GGAATTAATCGTAAA	fwd	down2
CGTCTTGAGGACGGT	fwd	down2
ACGACTACAATGACT	fwd	down2
GTCCGGAATCCAGAA	rev	down2
GAAGTAAAGAGCATC	rev	down2
CATCTCAGTATGACG	rev	down2
CAGCCGATTGGTCTT	rev	down2
AAGCGCATAAACCCT	rev	down2
GTCCGGAATCCAGAT	rev	down2
AGCGGTAAAAGACTA	rev	down2
CAGCCGATTCGTCTT	rev	down2
GCTACGGGCCAAAGC	rev	down2
CAACGCCTACAAAGC	2xfwd	down2
GCAGGTAGACACATC	2xfwd	down2
GTCGCGGGCAAGACG	2xfwd	down2
AACGAGAGTCACCTG	2xfwd	down2
AAAAAGGTGCCTGAT	2xfwd	down2
CAACGCCTACAAAGA	2xfwd	down2
ACAACAACCAACCAG	2xfwd	down2
GTCAACGACCCCGGA	2xfwd	down2
GCCAAGCTGAAGGGC	2xrev	down2
GGCGAAAACGTCCAT	2xrev	down2
GATAGACATCGGAAC	2xrev	down2
AAACTGGACAATAAC	2xrev	down2
AATAAAGTGGAGGTC	2xrev	down2
GCCAAGCTGAAGGGA	2xrev	down2
AAAACGACCAGCAGG	2xrev	down2
AACCGCATCCACATC	2xrev	down2