barcode	enhancer	orientation	location
CCCATCGCTGCCCTA	none	NA	up
AGCACGACCAAGGAG	none	NA	up
CCCGTCCTTCGCAGA	none	NA	up
GTAATAAGGGTCAAT	none	NA	up
CCGATAGTAACCAGC	none	NA	up
AACACGATAGGCACT	none	NA	up
AACGCAATAGACGAG	none	NA	up
CGCACTACCGGAGAC	none	NA	up
GAACAGATTAACAGC	none	NA	up
TACACGATAGGCACT	none	NA	up
GTCAACGACATGGGC	35S	fwd	up
ACTCACAGCAATACC	35S	fwd	up
ATAATAGGTGAAGCA	35S	fwd	up
ACCCTACAGAGGGTC	35S	fwd	up
AGAGTTATCCGTCAG	35S	fwd	up
AGAAGTCCCAACCTG	35S	fwd	up
CGAGTAGAACAACAC	35S	fwd	up
GCCGAAGTTCTACAG	35S	fwd	up
AGAAAAAAAGTACCG	35S	rev	up
CCACGACAAACAGTG	35S	rev	up
ATCGGACGGATAATT	35S	rev	up
GAAGATCAGAAACAA	35S	rev	up
AGGCAAGAGATCATT	35S	rev	up
AAAAATATCGAGCGG	35S	rev	up
CACCTAGGTGGGAAA	35S	rev	up
ACTACGGTGAAAATT	35S	rev	up
AAGGGAGTCCCGGAT	35S	rev	up
ATCCACCTAGACGCT	Cab-1	fwd	up
ATACAAAGACGAAAG	Cab-1	fwd	up
ATACCTGGCGACATG	Cab-1	fwd	up
ATAGCCCGTCAAACA	Cab-1	fwd	up
ATCACAGTGGTCAAA	Cab-1	fwd	up
ATACGTCGTGAGAAT	Cab-1	fwd	up
GATGGGGTTAAACTC	Cab-1	fwd	up
GCACATGCGAACACT	Cab-1	fwd	up
GGACTAACGGAGATT	Cab-1	fwd	up
AACGCCGCTGGTACA	Cab-1	fwd	up
CTGGGAATTACAGAA	Cab-1	rev	up
AAACTTCATACAGAC	Cab-1	rev	up
AATGGAACGGCGACG	Cab-1	rev	up
GGAACGACTGTTACA	Cab-1	rev	up
GTGAACAAAGGCAGA	Cab-1	rev	up
GTACATAACCCCATC	Cab-1	rev	up
GGACCCAGTGAAAAG	Cab-1	rev	up
CAAAACATCATTCTC	Cab-1	rev	up
ACAAGGATTACAGAC	Cab-1	rev	up
CGGAGTCCCAGAGAT	Cab-1	rev	up
AAACCACTAAGCACG	AB80	fwd	up
AACCAACAAAAGACT	AB80	fwd	up
AATCCTAAAGGCAGG	AB80	fwd	up
CCCCCGACTCATAGA	AB80	fwd	up
ACCAAAGGCCTTCAA	AB80	fwd	up
CTACCTACACGGATT	AB80	fwd	up
CCGGCTGGTACCCGA	AB80	fwd	up
ACTACGGCTGCAAAT	AB80	fwd	up
CCGAATAAACATATG	rbcS-E9	fwd	up
CGACAACTAGGTAAC	rbcS-E9	fwd	up
ACAAACAGAACTATG	rbcS-E9	fwd	up
CACCAAGTACTTCCT	rbcS-E9	fwd	up
GACCAACGAGGGGAA	rbcS-E9	fwd	up
CCTAGTCGTATGGAC	rbcS-E9	fwd	up
ACACAAATAGGACAT	rbcS-E9	fwd	up
ATGATAACTGATGTG	rbcS-E9	fwd	up
AAACAGCTTGCACGT	rbcS-E9	fwd	up
CAAGCTAACATAAGA	AB80	rev	up
AAAGCCACGGGCGCT	AB80	rev	up
AGTCACGCGGAAAAT	AB80	rev	up
CCTCCCAAGGAGCAC	AB80	rev	up
GTTCGACTACTAACA	AB80	rev	up
AGCGGTCGAGGTAGA	AB80	rev	up
CCTAGTACGCACACC	AB80	rev	up
ACCCCGCACCAAATA	AB80	rev	up
CGTGCGATTCAAATA	AB80	rev	up
GTAATCCAACTCCAC	AB80	rev	up
ACGCTAGCCACCCAA	rbcS-E9	rev	up
GTAATAAAGACTACT	rbcS-E9	rev	up
ATCACTATCGCAGAA	rbcS-E9	rev	up
ATAGAGGTTGATAAG	rbcS-E9	rev	up
AATACAGGAACCAAT	rbcS-E9	rev	up
CTGCCAAGTATTATA	rbcS-E9	rev	up
GGCATGGCAAACGAT	rbcS-E9	rev	up
ATCAGACTACAAGGA	rbcS-E9	rev	up
ATAGCCGCTAGGGGA	rbcS-E9	rev	up