barcode	enhancer	location
GTCAACGACATGGGC	35S	up
ACTCACAGCAATACC	35S	up
ATAATAGGTGAAGCA	35S	up
ACCCTACAGAGGGTC	35S	up
AGAGTTATCCGTCAG	35S	up
AGAAGTCCCAACCTG	35S	up
CGAGTAGAACAACAC	35S	up
GCCGAAGTTCTACAG	35S	up
CATCATGCAGTAATA	35S	up
GTCCAGGGCCATAGT	35S	down
CTTCGTCCGAGCGAA	35S	down
CTCCGAGGACTCGGG	35S	down
AAAGCTATGGCTCCT	35S	down
CCTCCAGTTCGAGAT	35S	down
CCGAAAGATATCGTC	35S	down
CCCATCGCTGCCCTA	none	up
AGCACGACCAAGGAG	none	up
CCCGTCCTTCGCAGA	none	up
GTAATAAGGGTCAAT	none	up
CCGATAGTAACCAGC	none	up
AACACGATAGGCACT	none	up
AACGCAATAGACGAG	none	up
CGCACTACCGGAGAC	none	up
GAACAGATTAACAGC	none	up
TACACGATAGGCACT	none	up
AAAGCACAAAGCCGC	none	down
AGAAACCAGAACCAT	none	down
AGTACGGACGTGGTC	none	down
CAAACAACGACAACG	none	down