barcode	enhancer	spacer	distance
GTCACTGTAGTAAGA	TRUE	TRUE	0.5
GATCGAAAAAATCAT	TRUE	TRUE	0.5
ATCCAGAGGGAAAGC	TRUE	TRUE	0.5
AAGAACCAAAGTGAC	TRUE	TRUE	0.5
GGACCTGTGACGCGT	TRUE	TRUE	0.5
AGAAAAACGAGGCCC	TRUE	TRUE	0.5
CCTACTGAGCACCTA	TRUE	TRUE	0.5
GACACTGACATAGAG	TRUE	TRUE	0.5
CAAATACATGAGAAT	TRUE	TRUE	0.5
CATCATGCAGTAATA	TRUE	TRUE	0.5
AAAGAAAAGCTACGT	TRUE	TRUE	1.5
AAACCTGCTGACAGT	TRUE	TRUE	1.5
CCTCAGGCCGGTAGG	TRUE	TRUE	1.5
GTCCGTGGACACCAA	TRUE	TRUE	1.5
ATAGAACACACAGAA	TRUE	TRUE	1.5
ACCCCTGGTCCAATG	TRUE	TRUE	1.5
AGTATCGGAAACGAT	TRUE	TRUE	1.5
AAACACCGAGCCATA	TRUE	TRUE	1.5
GCTCCTGTAGTAAAA	TRUE	TRUE	1.5
AAACTAAAACCTGAA	TRUE	TRUE	1.5
GTACCTAGTGACAGC	TRUE	TRUE	2
AATCGCCGGAGGGCA	TRUE	TRUE	2
GATAGGAGACATGGT	TRUE	TRUE	2
GCCGCTGCAAAGAAA	TRUE	TRUE	2
CAACTAGACCTGACT	TRUE	TRUE	2
CTCACGGACGGGCAA	TRUE	TRUE	2
AGCACCCGAACACGG	TRUE	TRUE	2
GATACAAGACAAACA	TRUE	TRUE	2
ATAGCACGCGTTCGT	TRUE	TRUE	2
ACCAAAATGACTATG	TRUE	TRUE	0
CGTCCACTCGATATC	TRUE	TRUE	0
CACGAAGCAGGTAGC	TRUE	TRUE	0
ATACCCCTAGCTAGA	TRUE	TRUE	0
GCGCTAATCACACCA	TRUE	TRUE	0
CGTCCACTCGTTATC	TRUE	TRUE	0
ACTAAAACGATAGCC	TRUE	TRUE	0
ACCAAAATGAGTATG	TRUE	TRUE	0
ACACGTGGTAACGTG	TRUE	TRUE	0
AAAGAGAGCATCAGG	TRUE	TRUE	1
AGTATAATGAGCGTC	TRUE	TRUE	1
CAACCTGATCTTGTG	TRUE	TRUE	1
CGAATAGATCATCAA	TRUE	TRUE	1
ACTCGAACAGCCGTT	TRUE	TRUE	1
CGTAGACAAATTCCA	TRUE	TRUE	1
CGAATAGATCTTCAA	TRUE	TRUE	1
GTGAGAATTCCGGTC	TRUE	TRUE	1
AAAGAGAGCATCAGT	TRUE	TRUE	1
AGTATAATGAGCGAC	TRUE	TRUE	1
AAGAGTAACGGTATC	FALSE	TRUE	0
GCTCGTGCTGAAGAA	FALSE	TRUE	0
GGTGTCAGGACCAGC	FALSE	TRUE	0
GATGTGCTCGCCCAT	FALSE	TRUE	0
CACAGTAAAACCGTT	FALSE	TRUE	0
CCTGCAGTGCAGAGC	FALSE	TRUE	0
GGTGTCAGGACCAGA	FALSE	TRUE	0
AATGTGATGGTAAAT	FALSE	TRUE	0
ACACTCGAACAAACT	FALSE	TRUE	0
AGGGTTAGAGACAGT	FALSE	TRUE	0