barcode	enhancer	intron	location
CCCATCGCTGCCCTA	FALSE	FALSE	upstream
AGCACGACCAAGGAG	FALSE	FALSE	upstream
CCCGTCCTTCGCAGA	FALSE	FALSE	upstream
GTAATAAGGGTCAAT	FALSE	FALSE	upstream
CCGATAGTAACCAGC	FALSE	FALSE	upstream
AACACGATAGGCACT	FALSE	FALSE	upstream
AACGCAATAGACGAG	FALSE	FALSE	upstream
CGCACTACCGGAGAC	FALSE	FALSE	upstream
GAACAGATTAACAGC	FALSE	FALSE	upstream
TACACGATAGGCACT	FALSE	FALSE	upstream
GTCAACGACATGGGC	TRUE	FALSE	upstream
ACTCACAGCAATACC	TRUE	FALSE	upstream
ATAATAGGTGAAGCA	TRUE	FALSE	upstream
ACCCTACAGAGGGTC	TRUE	FALSE	upstream
AGAGTTATCCGTCAG	TRUE	FALSE	upstream
AGAAGTCCCAACCTG	TRUE	FALSE	upstream
CGAGTAGAACAACAC	TRUE	FALSE	upstream
GCCGAAGTTCTACAG	TRUE	FALSE	upstream
CATCATGCAGTAATA	TRUE	FALSE	upstream
CAGCGGAAAGTAGTT	TRUE	TRUE	intron
AGCCGCAGGGACAGT	TRUE	TRUE	intron
GCGCCAGGGACACGG	TRUE	TRUE	intron
AACCGCGGAGTCGCA	TRUE	TRUE	intron
ATCGCACCGAGGGCG	TRUE	TRUE	intron
CGAACCGCGATTCGA	TRUE	TRUE	intron
GAGCCTATGATAGGC	TRUE	TRUE	intron
AGAATTGTTACACAA	TRUE	TRUE	intron
ACAAGAGTACGCGGG	TRUE	TRUE	intron
CTCCATGTTCATAGC	TRUE	TRUE	intron
CATGAAAATATCATA	FALSE	TRUE	intron
GCACGTCGCATCCAC	FALSE	TRUE	intron
CAAATGGCCAAGCGT	FALSE	TRUE	intron
ATTCCGGATATCAGG	FALSE	TRUE	intron
AAACTTAGAACGCCA	FALSE	TRUE	intron
CTCCGGGCTAGCGCA	FALSE	TRUE	intron
ACGAAGCAACTAGAT	FALSE	TRUE	intron
ATAGCGATCCCAGCA	FALSE	TRUE	intron
ATCCCTGCTGGCCGT	FALSE	TRUE	intron
GTAGGTAGGACTATC	FALSE	TRUE	intron
CAAAGAACCCGGCGT	TRUE	TRUE	upstream
AATAACGTGGAAATC	TRUE	TRUE	upstream
AGCGAAGCTGTACAC	TRUE	TRUE	upstream
AGGGCAACCGTGGCG	TRUE	TRUE	upstream
CCCCGAACCGGTGCA	TRUE	TRUE	upstream
ACTCGGGTAAAAGCA	TRUE	TRUE	upstream
CGCAACAAACACCTT	TRUE	TRUE	upstream
ACAATTATGAGAGTA	TRUE	TRUE	upstream
CGACGGACAACGCAG	TRUE	TRUE	upstream
ACACGCGTGCTCGCT	TRUE	TRUE	upstream
CAGACTCAAAAGGTG	FALSE	TRUE	upstream
GATCTTCCTGAACAA	FALSE	TRUE	upstream
GTGCAACATAGTGAA	FALSE	TRUE	upstream
ACAAATCGTCAGCTA	FALSE	TRUE	upstream
AACCATCCTAGAAAA	FALSE	TRUE	upstream
GCGACAACGAGGATG	FALSE	TRUE	upstream
ACAGGAGGTCTTATA	FALSE	TRUE	upstream
GTTAATAACCCAGCA	FALSE	TRUE	upstream
CCAACGATGGCACAC	FALSE	TRUE	upstream
ACCCCTAGGCACGCG	FALSE	TRUE	upstream