barcode	enhancer	orientation	location
AAAGCACAAAGCCGC	none	NA	down
AGAAACCAGAACCAT	none	NA	down
AGTACGGACGTGGTC	none	NA	down
CAAACAACGACAACG	none	NA	down
GTCCAGGGCCATAGT	35S	fwd	down
CTTCGTCCGAGCGAA	35S	fwd	down
CTCCGAGGACTCGGG	35S	fwd	down
AAAGCTATGGCTCCT	35S	fwd	down
CCTCCAGTTCGAGAT	35S	fwd	down
CCGAAAGATATCGTC	35S	fwd	down
AATATACCAAGCAGC	35S	rev	down
ACAACTCCTATCACT	35S	rev	down
AGCACCGAAGATCCA	35S	rev	down
AGCCCCCACAGCGCT	35S	rev	down
CAACATAAAGTACGC	35S	rev	down
CTCGGTATTCCAGAC	35S	rev	down
GACATGGTACAAAGT	35S	rev	down
AGAATTCTAGCGGGC	35S	rev	down
GCACACACTAGGGGT	35S	rev	down
GCCCTGAAACTCAGC	35S	rev	down
CCCATCGCTGCCCTA	none	NA	up
AGCACGACCAAGGAG	none	NA	up
CCCGTCCTTCGCAGA	none	NA	up
GTAATAAGGGTCAAT	none	NA	up
CCGATAGTAACCAGC	none	NA	up
AACACGATAGGCACT	none	NA	up
AACGCAATAGACGAG	none	NA	up
CGCACTACCGGAGAC	none	NA	up
GAACAGATTAACAGC	none	NA	up
TACACGATAGGCACT	none	NA	up
GTCAACGACATGGGC	35S	fwd	up
ACTCACAGCAATACC	35S	fwd	up
ATAATAGGTGAAGCA	35S	fwd	up
ACCCTACAGAGGGTC	35S	fwd	up
AGAGTTATCCGTCAG	35S	fwd	up
AGAAGTCCCAACCTG	35S	fwd	up
CGAGTAGAACAACAC	35S	fwd	up
GCCGAAGTTCTACAG	35S	fwd	up
AGAAAAAAAGTACCG	35S	rev	up
CCACGACAAACAGTG	35S	rev	up
ATCGGACGGATAATT	35S	rev	up
GAAGATCAGAAACAA	35S	rev	up
AGGCAAGAGATCATT	35S	rev	up
AAAAATATCGAGCGG	35S	rev	up
CACCTAGGTGGGAAA	35S	rev	up
ACTACGGTGAAAATT	35S	rev	up
AAGGGAGTCCCGGAT	35S	rev	up
AAACGCACACGGGGG	none	NA	up2
CGACAGAGAATGGCG	none	NA	up2
CAGAATAATATACTA	none	NA	up2
GCTGACCCGACCAGC	none	NA	up2
CACAGAAAGCGTGCG	none	NA	up2
ACAATAGAACCAGAG	none	NA	up2
CGACCTATACGGACA	none	NA	up2
ACTACGGTTACTGGA	none	NA	up2
GGGCTCAAACTTATC	none	NA	up2
CACAGCAATGAAGCT	35S	fwd	up2
GGGGCCCCGAATCTA	35S	fwd	up2
CAAATACTTCACAGC	35S	fwd	up2
CACAAGGACGTTCCG	35S	fwd	up2
AGGGCCAGCCGAAGT	35S	fwd	up2
GGCGTACGAAAGACA	35S	fwd	up2
GATACCGTACCAGTA	35S	fwd	up2
AAGAGTCGCGGGGCT	35S	fwd	up2
GGGGCCAGCCGAAGT	35S	fwd	up2
AACATTAACAGCGTG	35S	fwd	up2
ACTCTTGAACATGCA	35S	rev	up2
CGTGCACAAAAGGTG	35S	rev	up2
GGCATCGAAATCCTT	35S	rev	up2
GGTCTGAAGCTTGAT	35S	rev	up2
ATAAATAGCCGCCGG	35S	rev	up2
GTGCTGCAACCGGGC	35S	rev	up2
GTGCTCGGCATGAAA	35S	rev	up2
GCTAGGCTACTTCGA	35S	rev	up2
GCTCTTGAACATGCA	35S	rev	up2
CGGCCTAGGATTATA	35S	rev	up2
ATGAACCATGGCCTA	none	NA	down2
ACACACACAATCCAG	none	NA	down2
GACGGGCAACCACTA	none	NA	down2
CATCACATTAAAACT	none	NA	down2
ATGAACCATCGCCTA	none	NA	down2
AACGGTGTACGTCCC	none	NA	down2
GAACAGCCAGACGTG	none	NA	down2
ACGCAAGCAACACGT	none	NA	down2
GTCGACGTCCTAAAG	none	NA	down2
CTCAATCGGACACTA	35S	fwd	down2
ATTAGTGATACTCCA	35S	fwd	down2
AGGAGGATGCTCAAA	35S	fwd	down2
GGAATTAATCGTAAA	35S	fwd	down2
CGTCTTGAGGACGGT	35S	fwd	down2
ACGACTACAATGACT	35S	fwd	down2
GTCCGGAATCCAGAA	35S	rev	down2
GAAGTAAAGAGCATC	35S	rev	down2
CATCTCAGTATGACG	35S	rev	down2
CAGCCGATTGGTCTT	35S	rev	down2
AAGCGCATAAACCCT	35S	rev	down2
GTCCGGAATCCAGAT	35S	rev	down2
AGCGGTAAAAGACTA	35S	rev	down2
CAGCCGATTCGTCTT	35S	rev	down2
GCTACGGGCCAAAGC	35S	rev	down2
ATCCACCTAGACGCT	Cab-1	fwd	up
ATACAAAGACGAAAG	Cab-1	fwd	up
ATACCTGGCGACATG	Cab-1	fwd	up
ATAGCCCGTCAAACA	Cab-1	fwd	up
ATCACAGTGGTCAAA	Cab-1	fwd	up
ATACGTCGTGAGAAT	Cab-1	fwd	up
GATGGGGTTAAACTC	Cab-1	fwd	up
GCACATGCGAACACT	Cab-1	fwd	up
GGACTAACGGAGATT	Cab-1	fwd	up
AACGCCGCTGGTACA	Cab-1	fwd	up
CTGGGAATTACAGAA	Cab-1	rev	up
AAACTTCATACAGAC	Cab-1	rev	up
AATGGAACGGCGACG	Cab-1	rev	up
GGAACGACTGTTACA	Cab-1	rev	up
GTGAACAAAGGCAGA	Cab-1	rev	up
GTACATAACCCCATC	Cab-1	rev	up
GGACCCAGTGAAAAG	Cab-1	rev	up
CAAAACATCATTCTC	Cab-1	rev	up
ACAAGGATTACAGAC	Cab-1	rev	up
CGGAGTCCCAGAGAT	Cab-1	rev	up
CATGAAAAGATCAGG	AB80	fwd	down2
CGTCAGGGACAACAG	AB80	fwd	down2
CAAAGACTGGTACAT	AB80	fwd	down2
ACAATTGACGTGGCT	AB80	fwd	down2
CCTAATACTGTTAGG	AB80	fwd	down2
CGTCGGCTGGGAGGG	AB80	fwd	down2
CTAGACAAACGAAGA	AB80	fwd	down2
AACCGGCTTGCCACC	AB80	fwd	down2
ACACCGCATATTGCC	AB80	fwd	down2
GTACCAAGAAAGGTA	AB80	fwd	down2
AGCATAATCGATGCA	Cab-1	fwd	down2
AGTACCAACGTAAGG	Cab-1	fwd	down2
CGCATTCGTCTACTG	Cab-1	fwd	down2
CTCCATATAAGCAGC	Cab-1	fwd	down2
ATTCTTAAAACCGCA	Cab-1	fwd	down2
GGACCCATTGAAAGC	Cab-1	fwd	down2
ATCATAGAACATGGG	Cab-1	fwd	down2
GAGCGGATGATCATA	Cab-1	fwd	down2
CTCGCTATTACTACG	Cab-1	fwd	down2
CTAAATGAGACGGCG	Cab-1	fwd	down2
CCGCCAAGCGACCTT	rbcS-E9	fwd	down2
ACTAGACTCGGAGCA	rbcS-E9	fwd	down2
AAAGTACGGAATCTC	rbcS-E9	fwd	down2
GACACGGCGCCTAGT	rbcS-E9	fwd	down2
AGCCAAACAGATCCT	rbcS-E9	fwd	down2
GTACTCAGAGCGGGT	rbcS-E9	fwd	down2
GCAGTCGAGCCGCGG	rbcS-E9	fwd	down2
GGGACCATAACTGAA	rbcS-E9	fwd	down2
AGGAATACAACTGCC	rbcS-E9	fwd	down2
GCGATGCTTAACCGT	rbcS-E9	fwd	down2
GCCATAACAAATATG	AB80	fwd	down
ATTACCCACAATGGT	AB80	fwd	down
CACCTGGTGATTCAG	AB80	fwd	down
GACGACAATGATAAA	AB80	fwd	down
ACACGGCGTGTCCTT	AB80	fwd	down
CAGGGCATACCCAGC	AB80	fwd	down
GACAAGCGGAATAAT	AB80	fwd	down
AAACGAGTGCAAAAG	AB80	fwd	down
CCTGTCATACACCAG	AB80	fwd	down
GTACGCGATATCCAG	AB80	fwd	down
CCGGGACAAAACATG	Cab-1	fwd	down
ATCATGATAATGGAC	Cab-1	fwd	down
GTAAAGAAAAGGCAT	Cab-1	fwd	down
AACCGTAGCCCGGCG	Cab-1	fwd	down
CTCGACATAGGTACA	Cab-1	fwd	down
AACCCAGAGATTAAC	Cab-1	fwd	down
AACCTAACTCTTACG	Cab-1	fwd	down
CGGATTACTGGGCGA	Cab-1	fwd	down
CCTACAATTGACAGA	Cab-1	fwd	down
CAACGTAACGCCGCA	Cab-1	fwd	down
GAACAAAAGCTGCCA	rbcS-E9	fwd	down
CGTCCTAGCATGCCA	rbcS-E9	fwd	down
GCAATCACGGGAGCA	rbcS-E9	fwd	down
GTCCGTGAGAACGCC	rbcS-E9	fwd	down
CGCCGGGACACGAAG	rbcS-E9	fwd	down
AGTCGTAGAACTGCT	rbcS-E9	fwd	down
CTCGCGCCGCCCGCA	rbcS-E9	fwd	down
ACAAATGCAAATAAG	rbcS-E9	fwd	down
ACTAGACGGAGCATA	rbcS-E9	fwd	down
GTTACCGAAGTAAAC	rbcS-E9	fwd	down
CTTACTACTCTCAGA	AB80	fwd	up2
GACGATACTAACGCG	AB80	fwd	up2
CCTGGACCTCCACCC	AB80	fwd	up2
AAGCCCACTAGACCG	AB80	fwd	up2
AGGATGAACATAATT	AB80	fwd	up2
GGTCAGCACGTAGCA	AB80	fwd	up2
ATACGTGTTCTTACG	AB80	fwd	up2
AGTCACCTGCGGCAG	AB80	fwd	up2
GACCGTAGGCGAGAA	AB80	fwd	up2
CCCACAACAGAACTA	Cab-1	fwd	up2
AAAGAAATTGAAAGT	Cab-1	fwd	up2
GTAAGAGCCAACAAG	Cab-1	fwd	up2
AAGCAAAGGCCCCGT	Cab-1	fwd	up2
ACCAGGAATAGGGGA	Cab-1	fwd	up2
ATTATTCAACACAAG	Cab-1	fwd	up2
CGGCAGGGCATGCTA	Cab-1	fwd	up2
CCCATGGATGCGAGA	Cab-1	fwd	up2
CCTCAAACAAGGATA	Cab-1	fwd	up2
GAGCTGAGCCAAATG	Cab-1	fwd	up2
ACTACTAATCAGGCT	rbcS-E9	fwd	up2
GTAGGCGATAATATT	rbcS-E9	fwd	up2
GGAAGAGATAGTACC	rbcS-E9	fwd	up2
ATCAGAGTAGCTACT	rbcS-E9	fwd	up2
ACGGAACACATTAAC	rbcS-E9	fwd	up2
CAAGCACTGATACCT	rbcS-E9	fwd	up2
ATCATTACCACAGAC	rbcS-E9	fwd	up2
GACCAGCCTGTACAG	rbcS-E9	fwd	up2
CAACGGATGGTCCTA	rbcS-E9	fwd	up2
GCGGCCGGGGGACCG	rbcS-E9	fwd	up2
AAACCACTAAGCACG	AB80	fwd	up
AACCAACAAAAGACT	AB80	fwd	up
AATCCTAAAGGCAGG	AB80	fwd	up
CCCCCGACTCATAGA	AB80	fwd	up
ACCAAAGGCCTTCAA	AB80	fwd	up
CTACCTACACGGATT	AB80	fwd	up
CCGGCTGGTACCCGA	AB80	fwd	up
ACTACGGCTGCAAAT	AB80	fwd	up
CCGAATAAACATATG	rbcS-E9	fwd	up
CGACAACTAGGTAAC	rbcS-E9	fwd	up
ACAAACAGAACTATG	rbcS-E9	fwd	up
CACCAAGTACTTCCT	rbcS-E9	fwd	up
GACCAACGAGGGGAA	rbcS-E9	fwd	up
CCTAGTCGTATGGAC	rbcS-E9	fwd	up
ACACAAATAGGACAT	rbcS-E9	fwd	up
ATGATAACTGATGTG	rbcS-E9	fwd	up
AAACAGCTTGCACGT	rbcS-E9	fwd	up
AAAGATCCGGTCGAG	AB80	rev	down2
CGCCTTGAAAGTAGG	AB80	rev	down2
GTCAGCCGACAAAGA	AB80	rev	down2
GCGAGGATAACTCAC	AB80	rev	down2
CGAGATACAGATAAA	AB80	rev	down2
GCAAGTGCCACCAGT	AB80	rev	down2
CACCATCATGACGAG	AB80	rev	down2
GACCGCACAAAAGCC	AB80	rev	down2
CTTCTAAAAACTGCA	Cab-1	rev	down2
ATTAGTACGGGAACA	Cab-1	rev	down2
CATACTATACGTGAG	Cab-1	rev	down2
CCCGCCATCGTCGTT	Cab-1	rev	down2
ACAGACAGCAAGCAA	Cab-1	rev	down2
ATAGCGAACACTAGG	Cab-1	rev	down2
GATCATACTGAAAGA	Cab-1	rev	down2
GTGACGGCTAGGCAC	Cab-1	rev	down2
ACAATTCTTAGCGTG	Cab-1	rev	down2
ATGGAGAGAATAGTA	Cab-1	rev	down2
GATAGGCGTGTAGCC	rbcS-E9	rev	down2
AGACGTAACAGAATG	rbcS-E9	rev	down2
AGTCACCTAGGGGGC	rbcS-E9	rev	down2
AAAACCATACCAAAT	rbcS-E9	rev	down2
GGTATCGCCGGTATT	rbcS-E9	rev	down2
GACCTGGAACACCAG	rbcS-E9	rev	down2
CCGCAAACGCCCAGC	rbcS-E9	rev	down2
ACTCGTAAGAAACCA	rbcS-E9	rev	down2
AGTGTTCAGGGGGGA	rbcS-E9	rev	down2
CTTCCCAAACGAGAC	AB80	rev	down
CGAGCTACCAAAATT	AB80	rev	down
ACGCTTACGACCATG	AB80	rev	down
ACACGAAATGCCCCT	AB80	rev	down
GTACGCCCGAATGGA	AB80	rev	down
ACGATGGGGGCTCCA	AB80	rev	down
AACCAAGTTCCTAGC	AB80	rev	down
GACCCAGGACTTGCA	AB80	rev	down
ATTAGAGTACGGAAA	AB80	rev	down
ATCCTTAATGCGCGT	Cab-1	rev	down
CTACACGTCAGCAAA	Cab-1	rev	down
ATCACGACGAATGAA	Cab-1	rev	down
CGCGATGGCCTTGCA	Cab-1	rev	down
AAAACTGTTATAGCT	Cab-1	rev	down
CCGGTTAAAGATATG	Cab-1	rev	down
CGTGAGACGGAGCAA	Cab-1	rev	down
GTTGCTGCACAAAAG	Cab-1	rev	down
GGCGGTCAGGCACTC	Cab-1	rev	down
AGTAAAGTTACCCGT	rbcS-E9	rev	down
GGGAAGCGAATTAGC	rbcS-E9	rev	down
GACGTCATTGCTCAC	rbcS-E9	rev	down
ACACGCGCTCGGAGC	rbcS-E9	rev	down
ACTAAGCCGGATAGC	rbcS-E9	rev	down
CCTATAGAGCATCAT	rbcS-E9	rev	down
ACGCTTATACGCCAG	rbcS-E9	rev	down
CTCCAGCGTAAAAGA	AB80	rev	up2
AGGCCGAGACTGGCC	AB80	rev	up2
ACAACAGTTATTGAA	AB80	rev	up2
GGCCTCGAAGCTCGA	AB80	rev	up2
ATAAGACGAGAGCCG	AB80	rev	up2
CGTAAGATAGTGAGA	AB80	rev	up2
GCACGTGCACGTGTA	AB80	rev	up2
GGCGTCAAACGCACC	AB80	rev	up2
CTTGTCAAACGTAGA	AB80	rev	up2
AATGTAAGTAACCGC	AB80	rev	up2
AGACGTGAAACGGTA	Cab-1	rev	up2
ACGAATAAGCTGAGA	Cab-1	rev	up2
CAACACACGCAACGT	Cab-1	rev	up2
GATCGTATCCAGGAG	Cab-1	rev	up2
CAAGCAACAAAAGGT	Cab-1	rev	up2
AAAACTCACACAGAC	Cab-1	rev	up2
AGTAGAAAAAACAAT	Cab-1	rev	up2
ACTAATAAGATGGTG	Cab-1	rev	up2
GACCTCGGGGTTCGC	Cab-1	rev	up2
CGGCTAGGCCCTGTG	Cab-1	rev	up2
CAGATTAGTGGTAAT	rbcS-E9	rev	up2
ACAAAAGGTCAGCTA	rbcS-E9	rev	up2
CTGCGTGAAAACACG	rbcS-E9	rev	up2
ATCCAAAGGCCCGCA	rbcS-E9	rev	up2
ACGGCGATCGGCATA	rbcS-E9	rev	up2
GTCCCAGAAGTGACA	rbcS-E9	rev	up2
ACCAACGCCGCTGGC	rbcS-E9	rev	up2
ACGCCTGACACTCAA	rbcS-E9	rev	up2
CTACGGGAAATGCAC	rbcS-E9	rev	up2
ACTAGTCCAAATGTT	rbcS-E9	rev	up2
CAAGCTAACATAAGA	AB80	rev	up
AAAGCCACGGGCGCT	AB80	rev	up
AGTCACGCGGAAAAT	AB80	rev	up
CCTCCCAAGGAGCAC	AB80	rev	up
GTTCGACTACTAACA	AB80	rev	up
AGCGGTCGAGGTAGA	AB80	rev	up
CCTAGTACGCACACC	AB80	rev	up
ACCCCGCACCAAATA	AB80	rev	up
CGTGCGATTCAAATA	AB80	rev	up
GTAATCCAACTCCAC	AB80	rev	up
ACGCTAGCCACCCAA	rbcS-E9	rev	up
GTAATAAAGACTACT	rbcS-E9	rev	up
ATCACTATCGCAGAA	rbcS-E9	rev	up
ATAGAGGTTGATAAG	rbcS-E9	rev	up
AATACAGGAACCAAT	rbcS-E9	rev	up
CTGCCAAGTATTATA	rbcS-E9	rev	up
GGCATGGCAAACGAT	rbcS-E9	rev	up
ATCAGACTACAAGGA	rbcS-E9	rev	up
ATAGCCGCTAGGGGA	rbcS-E9	rev	up